0001111000001011000001000011001001100100000011110011000000010011010010100110100001000010000011010000
1010001001000100111100011010010010000100111001100100000011100000000100011010001001100010001100110101
0011010100110100001110110100101001101010000010100010001010111100001001000111010000011010x00010100010
0101010110000010011000100011001100010011100100110000001101100011101100010111011011010111001001011110
0101101100100111000001100001101001001000001001100010001100110111001101100011001100111011000100000110
1011001110110011010000100010000100010010101001110101000110000001001000110111011101100000011100100110
0010001100110001001100010011001100110011001100100011101101101000010101000011011100000100011101010100
1100010010000010110100100000010100110011011001111011000110010001110101001011010001000100000101000010
0101100000010101011010000111010001011110010101010000110100001010011110010000000100110101001001010111
0011010000010010101100000101000011010000101001010000000000110001011101010101000100010011110100011010
0010001001010100000101110100001001010110011011110101011100111001001010100101101001010001001001100010
0011001100010011011000110101001100100011101101011110011011010000110000001010011011010000100001010011
0111100000010010011010110011111000000010011001100111110001011011000111010001001000001110011110110001
0010011001000000110001110111010011000101101101010110010000100101100000100000000001110000011000010011
0101111100011100000000010001101000001000010110100001010001100010001001000001111000011011000010010101
0011010101010100010000000010011100110100011100100011010001100111110001010011010110110111111100001101
0000101000110100001101000001011100011001011011000101100100110000010001100010101000100110001000110011
0111001101100011100100111011001100010010011100001110001110110100111100011000000111010111110100111001
0110110000110100011001000110010101000000011100100000000100010100001001000100001001100000010111110001
101000011101010001110110001100011110001100000110101010011100010101000001100010011000010011101100100
000p0010101001101001011010110101001011000010101010010001101101110000110110011110101000111001010100010
011101110101