00000000000000000000
00000000000000000000
00000000000010000000
00000111111010000000
00000000000010001000
0001111000x010001000
00011110000010001000
00011110111110001000
00000000000000001000
00000011100111100000
00000011100000001000
00011011100010001000
00001100000110001000
00000110001110001000
00000011000000000000
00000001111111111100
00000000000000000000
00011111100001111000
000000p0000000000000
00000000000000000000