00000000000000000000
00000000000000000000
000000000000w0000000
00000wwwwww0w0000000
000000000000w000w000
000wwww432x0w000w000
000wwww54320w000w000
000wwww6wwwww000w000
0009998700000000w000
008888www00wwww00000
007777www0000000w000
066ww0www000w000w000
0555ww00000ww000w000
04444ww000www000w000
033330ww000000000000
0222220wwwwwwwwwww00
01111100000000000000
000wwwwww0000wwww000
000000p0000000000000
00000000000000000000