00000000000000000000
00000000000000000000
000000000000w0000000
00000wwwwww0w0000000
000000000000w000w000
000wwww000x0w000w000
000wwww00000w000w000
000wwww0wwwww000w000
0000000000000000w000
000000www00wwww00000
000000www0000000w000
000ww0www000w000w000
0000ww00000ww000w000
00000ww000www000w000
000000ww000000000000
0000000wwwwwwwwwww00
00000000000000000000
000wwwwww0000wwww000
000000p0000000000000
00000000000000000000